00000000000000
01000000111000
00000000000000
00011111000000
00001110000000
00000000000000
00000000000000
00100000000000
00100000000000
00100000110000
00000000100000
11122111111111
11222211111111
11222211111111
11122111111111